behavior - comportement, conduite
them - les, leur, eux
although - bien que, malgré que 
versatile - souple, aux talents variés
will - velonté, désir, vouloir
beyond - au-delà, plus de, sauf
provide - fournir, pourvoir, prévoir
allow - permettre, laisser, autoriser
further - plus loin, plus, davantage
however - cependant, toutefois
whichever - quel, celui qui, celle qui
prompting - incitation
rather - plutôt, assez, un peu
below - dessous, plus bas, en bas
unlike - contrairement à, différent
wherever - partout où
occurs - (produit) se produire
ensures - assure (assurer)
tweak - pincer
also - aussi
though - bien que (quoique)
kind - genre (espece, nature)
would - voudrais
feature - caractéristique (trait, particularité)
attempt - tentative (effort)
retrieve - récuperer (retrouver, rétablir)
been - été
will - volonté (désir, vouloir)
straightforward - simple (franc, juste, honnête)
rather - plutôt, (assez, un peu)
that has that - ce qui a
such - tel, pareil, tellement
these - ces, ceux
may - peut (avoir la possibilité de)
tedious - fastidieux, lassant
likewise - également
often - souvent
since - depuis, puisque